11111111111111111
12222222222222221
13333333333333331
1C0000000000C0001
12222220002222201
1WWWWWW002WWWWW01
1WWWWWW2GWWWWWW01
1WWWWWWWCWWWWWW01
1WWWWWW30WWWWWW01
1WWWWW3003WWWWW01
1E333300P033333C1
11111111111111111