11111111111111111111111111
12222222222222222122222221
1BBWBWWWW333WW333133333331
1BWWWW00E0000000020000C001
1BWW0000000000000300000001
11110111111111110111111111
12220222222222210222222221
13330333333333310333333331
1000000P0000C00100000C0001
10000000000000010000000001
11111111111111111111111111