1111111111111
1222222222221
13333333333E1
10C0011100001
1000022110001
1000011110001
1000012120001
1000023230001
1P00030300C01
1111111111111