1111111111111
10000000000E1
10C0011100001
1000000110001
1000011110001
1000010100001
1P00000000C01
1111111111111