111111111111111111111
121222222222222221221
131333333333333331331
101C001C10001000010C1
101111111011110001001
102222122022220001101
10333323E033330002201
100000300001111103301
101111011002222100001
102221021103C33101101
103331032200000202201
100P010033000003033C1
111111111111111111111