111111111111111111111
121222222222222222221
131333333333333333331
101C001C1000100000001
101111111011110000001
102222122022220000001
10333323E033330000001
100000300001111100001
101111011002222100001
102221021103C33100001
103331032200000200001
100P01003300000300001
111111111111111111111