11111111111111
1000E000000001
10000000000001
10000000000001
11111101111111
10000000000001
10C0000P000001
10000000000001
11111111111111